111111111111111
1P00000001
1000000001
10000000C1
1000000001
1000000001
1000000001
100000001
100000E000
11111111
